1111111111111111111111111111
1222222222222222222222222221
1211111111111121111111111121
1211111111111121111111111121
1222222222222222222222222221
1211111111111111111111111121
1211111111111111111111111121
1222222222222222222222222221
1211111111111121111111111121
1211111111111121111111111121
1222222222222222222222222221
1211111111111111111111111121
1211111111111111111111111121
1222222222222232222222222221
1211111111111121111111111121
1211111111111121111111111121
1222222222222232222222222221
1211111111111111111111111121
1211111111111111111111111121
1222222222222222222222222221
1211111111111121111111111121
1211111111111121111111111121
1222222222222222222222222221
1211111111111111111111111121
1211111111111111111111111121
1222222222222222222222222221
1211111111111121111111111121
1211111111111121111111111121
12222222222222222222222222P1
1111111111111111111111111111
1111111111111111111111111111

