1111111111111111111111111111
1000100000000000000000010001
1010101011111101111101010101
1010101000000000000001010101
1011101111111101111111011101
1000001000000101000001000001
1111101111110000011111011111
1000001000111111111001000001
1010100010100000001100010101
1010111111101111101111110101
1010000000101111101000000101
1010111011130000031010101101
1010101010100000001010101101
1010101110100000001010101101
1010000000030000030000000101
1010110111111111111111010101
1000000000001000100000000001
1011111111111101111111111101
1000000000100000001000000001
1010101010111111111010101011
1111111010100010001011111111
1000000011101010101000000001
1011101000001010100011011101
1000101111110000011111010001
1111101000000101000001011111
1000001111111101111111000001
1011101000000000000001011101
1010101011111101111101010101
12001000000000000000000100P1
1111111111111111111111111111
1111111111111111111111111111

