1111111111111111111111111111
1111111110000011111111111111
P000000300020001111111111111
1110110301101111111111111111
1110110000101111111111111111
1110011000000000111111111111
1111111111111110111111111111
1111111111111110111111111111
1111111111111110111111111111
1111111111111110111111111111
1111111111111110111111111111
1111111111111110111111111111
1111111111111110111111111111
1111111111000000011111111111
1111111111000000011111111111
1111111111000000011111111111
1111111111110001111111111111
1111111111110000000000011111
1111111111110001111111011111
1111111111110001111111011111
1111111111110001111111011111
1111111111110001111111011111
1111111111110001111111011111
1111111111110001111111011111
1111111111110001111111011111
1111111111110001111111011111
1111111111110001111111111111
1111111111110001111111111111
1111111111111001111111111111
1111111111111011111111111111
1111111111111111111111111111

