1111111111111111111111111111
1111111111111111111111111111
1111111111111111111111111111
1111111111111111111111111111
1111111111111111111111111111
1111111200000000111111111111
1111111111111110111111111111
1111111111111110111111111111
1111111111111110111111111111
1111111111111110111111111111
1111111111111110111111111111
1111111111111110111111111111
1111111111111110111111111111
1111111111230000011111111111
1111111111000000011111111111
1111111111000000011111111111
1111111111110001111111111111
1111111111110331111111111111
1111111111110001111111111111
1111111111110001111111111111
1111111111110001111111111111
1111111111110001111111111111
1111111111110001111111111111
1111111111110001111111111111
1111111111110001111111111111
1111111111110001111111111111
1111111111110001111111111111
1111111111110001111111111111
1111111111111001111111111111
1111111111111P11111111111111
1111111111111111111111111111

