1111111111111111111111111111
1111111111111111111111111111
1111111111111111111111111111
1111111111111111111111111111
1111111111111111111111111111
1111111111111111111111111111
1111111111111111111111111111
1111111111111111111111111111
1111111111111111111111111111
1111111111111111111111111111
1111111111111111111111111111
1111111111111111111111111111
1111111111111111111111111111
1111111111000000011111111111
1111111111000C00011111111111
1111111111000000011111111111
1111111111110001111111111111
1111111111110001111111111111
1111111111110001111111111111
1111111111110001111111111111
1111111111110001111111111111
1111111111110001111111111111
1111111111110001111111111111
1111111111110001111111111111
1111111111110001111111111111
1111111111110001111111111111
1111111111110001111111111111
1111111111110001111111111111
1111111111111001111111111111
1111111111111P11111111111111
1111111111111111111111111111

