1111111111111111111111111111
1000000000000000000000000001
1011111111111101111111111101
1011111001100000001100111101
1000001100001111100001100001
1011100001111111111100001101
1011110100000000000001011101
1011110110111111110111011101
1011110010000110000100011101
1011111011110110111101111101
1011111011110110111101111101
1011111010000000000101111101
1011111010101111010101111101
1011111010150000410101111101
1000000000000000000000000001
1011110110160000310110111101
1011110110101111010110111101
1011110110000000000110111101
1011110110110110110110111101
1011110110110110110110111101
1011110000000110000000111101
1011110111110110111110111101
1011110111110110111110111101
1000110000000020000000110001
1010111011110101011101110101
1010111011110101011101110101
1000111011110101011101110001
1010000001110101011000000101
1011111111110101011111111101
1000000000000P00000000000001
1111111111111111111111111111

