1111111111111111111111111111
1222222222222222222222222221
1211111111112112111111111121
1211111221122222211221111121
1222221122221111222211222221
1211122221111111111222211121
1211112122222222222212111121
1211112111111111111112111121
1211112211111111111122111121
1211111211122222211121111121
1211111211121111211121111121
1211111211121111211121111121
1211111211121111211121111121
1211111211131111311121111121
1222222222221111222222222221
1211211111132222311111121121
1211222111111111111112221121
1211112111111111111112111121
1211112111111111111112111121
1211112222222222222222111121
1211112111111111111112111121
1211112221111111111222111121
1211111122211111122211111121
1211111111222222221111111121
1211111111112112111111111121
1211111111112112111111111121
1211111111112112111111111121
1211111111112112111111111121
1211111111112112111111111121
1222222222222P22222222222221
1111111111111111111111111111

