1111111111111111111111111111
1P00000000000000000000000001
1010110110110110110110110101
1010000110000110000110000101
1011110000110000110000111101
1011111110000110000111111101
1011111111110000111111111101
1011111110000110000111111101
1011110000110000110000111101
1010000110000110000110000101
1200110000110000110000110001
1010000110000110000110000101
1011110000110000110000111101
1011111110000110000111111101
1011111111113003111111111101
1010000000000000000000000001
1011111111113003111111111101
1011111110000110000111111101
1011110000110000110000111101
1010000110000110000110000101
1000110000110000110000110001
1010000110000110000110000101
1011110000110000110000111101
1011111110000110000111111101
1011111111110000111111111101
1011111110000110000111111101
1011110000110000110000111101
1010000110000110000110000101
1010110110110110110110110101
1000000000000000000000000001
1111111111111111111111111111

