1111111111111111111111111111
12222222222222222222222222P1
1211111111111111111111111121
1211111111111111111111111121
1211111111111111111111111121
1211122222222222222222222221
1211121111111111111111111121
1211121111111111111111111121
1211121111111111111111111121
1211122222222222222222211121
1211121112111111111111211121
1211121112111111111111211121
1211121112111111111111211121
1211121112111222222111211121
1211121112111311112111211121
1211121112222332222111211121
1211121112111131112111211121
1211121112222221112111211121
1211121111111111112111211121
1211121111111111112111211121
1211121111111111112111211121
1211122222222222222222211121
1211111111111111111111211121
1211111111111111111111211121
1211111111111111111111211121
1222222222222222222222211121
1211111111111111111111111121
1211111111111111111111111121
1211111111111111111111111121
1222222222222222222222222221
1111111111111111111111111111

