1111111111111111111111111111
12000000000000000000000000P1
1011111111111101111111111101
1110000000000000000000000001
1010111111111101111111111101
1010100000000000000001000101
1010101111111101101111110101
1010101000000000000000010101
1010101011111101111111010101
1010101010000000000001010101
1010101010111101111101010101
1010101011100000000101010101
1010101010101111110101010101
1010101010150000410101010101
1000100000000000000000000001
1010101010160000310101010101
1010101010101111010101010101
1010111010101000010101010101
1010101010101101010100010101
1010101010100000010101010101
1010101000111101111101010101
1010001010000000000101010101
1010101011111101111101010101
1010101000000000000001010101
1010101111111101111011110101
1011100000000000000000010101
1010111111111101111111110101
1010000000000000000000000101
1011111111111111111111111101
1000000000000000000000000001
1111111111111111111111111111

