1111111111111111111111111111
1P00000000000000000000000001
1010101010101010101010101011
1000000000000000000000000001
1010101010101010101010101011
1200000000000000000000000001
1101010101010101010101010101
1000000000000000000000000001
1101010101010101010101010101
1000000000000000000000000001
1010101010101010101010101011
1000000000000000000000000001
1010101010101010101010101011
1000000000050000400000000001
1010101010100000010101010101
1000000000060000300000000001
1101010101010101010101010101
1000000000000000000000000001
1101010101010101010101010101
1000000000000000000000000001
1010101010101010101010101011
1000000000000000000000000001
1010101010101010101010101011
1000000000000000000000000001
1101010101010101010101010101
1000000000000000000000000001
1101010101010101010101010101
1000000000000000000000000001
1010101010101010101010101011
1000000000000000000000000001
1111111111111111111111111111

