1111111111111111111111111111
1P22222222222222222222222211
1211111112111111121111111211
1211111112111111121111111211
1211111112111111121111111211
1222222222222222222222222221
1121111111211111112111111121
1121111111211111112111111121
1121111111211111112111111121
1222222222222222222222222221
1211111112111111121111111211
1211111112111111121111111211
1211111112111111121111111211
1222222222222222222222222221
1211111112111111112111111121
1211111113000000003111111121
1211111112111111112111111121
1222222222222222222222222221
1121111111211111112111111121
1121111111211111112111111121
1121111111211111112111111121
1222222222222222222222222221
1211111112111111121111111211
1211111112111111121111111211
1211111112111111121111111211
1222222222222222222222222221
1121111111211111112111111121
1121111111211111112111111121
1121111111211111112111111121
1122222222222222222222222221
1111111111111111111111111111

